######################
#              #     #
#    #       # #  #  #
#    #       #    # G#
######### ############
#     #              #
##   ##    ###########
#    #               #
# ## ###########     #
#    #               #
#          ####      #
################### ##
#              #     #
#    #       # #  #  #
#    #       #    #  #
######### ############
#     #              #
##   ##    ###########
#    #               #
# ## ###########     #
# S  #               #
#          ####      #
######################
