######################
#              #     #
#    #       # #  #  #
#    #       #    # G#
######### ######### ##
#     #              #
##   ##    ######## ##
#    #               #
# ## ###########     #
#    #               #
#          ####      #
################### ##
#              #     #
#    #       # #  #  #
#    #       #    #  #
######### ######### ##
#     #              #
##   ##    ######## ##
#    #               #
# ## ###########     #
# S  #               #
#          ####      #
######################
