WWWWWWWW
W.....WW
WKBBB.WW
W..WGGGW
WW....WW
WWWWWWWW
