WWWWWW
W.GWWW
W..WWW
W*K..W
W..B.W
W..WWW
WWWWWW
