WWWWWWW
WG..WWW
WGWB..W
WGKB..W
W..B.WW
WWW..WW
WWWWWWW
