WWWWWWWWW
WWW..WWWW
W.....B.W
W.W..WB.W
W.G.GWK.W
WWWWWWWWW
