WWWWWWWW
W......W
W.G**BKW
W......W
WWWWW..W
WWWWWWWW
