WWWWWWWW
WWW.GGKW
WWW.BB.W
WWWW.WWW
WWWW.WWW
WWWW.WWW
WWWW.WWW
W....WWW
W.W...WW
W...W.WW
WWW...WW
WWWWWWWW
