WWWWWW
WG..WW
WKBB.W
WW...W
WWW..W
WWWWGW
WWWWWW
