WWWWWWWWW
WWW....WW
WWW.WWKWW
WWW.W.B.W
W.GGW.B.W
W.......W
W..WWWWWW
WWWWWWWWW
