WWWWWWW
WWW..WW
WWG.BWW
WWGB.WW
WWGB.WW
WWGB.WW
WWG.BWW
WW...KW
WWW...W
WWWWWWW
