WWWWWW
W....W
W.WK.W
W.B*.W
W.G*.W
W....W
WWWWWW
