WWWWWWW
W.....W
W.GBG.W
W.BGB.W
W.GBG.W
W.BGB.W
W..K..W
WWWWWWW
