######################
# G   G              #
#    #       #S      #
#  S #       #       #
######### ############
#    G#           G  #
##   ##    ###########
#    #       S       #
# ## ###########     #
#    #            S  #
#S         ####      #
######################
