WWWWWWWWWWWW
WWWWWW.WWWWW
W....WWW...W
W.BB.....WKW
W.B.WGGG...W
W...WWWWWWWW
WWWWWWWWWWWW
