WWWWWWWWWWW
WWWWWWWG..W
WWWWWWWGW.W
WWWWWWWGW.W
W.K.B.B.B.W
W.W.W.W.WWW
W.......WWW
WWWWWWWWWWW
